11HHssFj1
00HHs0Fj1
1Q0ssFFj0
0Q00Af1j1
wQQQ0f0j1
w1yyyff10
w11yb====
0zz1b110=
00zz00000
