100000000
jjjjjLLL0
0A0BBl1LL
11G1ll111
1GGGl1o01
8881l1oo1
8ccc0vo01
800**0o11
0***1www1
