mmm1u0001
mmWuuu011
BBWWu0k01
10Q144k11
01Q044k11
QQQ14kk10
110U1V1b0
11UUUVOb0
010UvOOOO
