1====0011
v010=1441
0010o4441
kk1oooo1V
k0cD1A01V
k0cDDqFFF
k0c01q00F
000qqqHH0
111000HH1
