0000f011c
mmm1fYY1c
mmIffYY1c
1II0vlll1
0IVV1A1ll
0*MMM1G01
1*MM11GG0
0**100G01
00*101010
