001r01s10
0v1rr1sss
y1VVrr10s
yy0aC00k0
y1WWC11k1
GGGWC10k0
1G0A10kk0
11D000001
0DD111011
