011011+11
1***1+++0
**rrva+10
100rr=0HH
ccc1r=1HH
011b1=A10
101b==0SS
011LLL0S1
01LL11SS0
