P01EEEE10
PPP1000I0
P111000II
0M1ddWr1I
MMvdWWrr0
MM0*a00rr
10**0ii00
11*1VVii1
00*001110
