0u101B011
uuu01B1U0
1u0rr1UUU
10rrvA0U0
00rVl1Q01
0d1Vl1Q01
ddz1llQQQ
W0zz1l001
WW1z00001
