55110VV00
50XXXmmx1
55iiXmmx0
NNNii1mx1
N0N10a1x1
0A0B01e10
001B00e01
FFF001e00
F11111e01
