0o0nnn101
0o1n1n11I
1oo11y0II
1o01yyyI0
c1JJJJJvC
c1000<<1C
c01f0<00C
0fff<<HH0
0www10HH1
