001x1ggg1
1L0x10g01
LL1xnn000
L01xn1001
LVV1nn001
=NNv11f00
=N1CCCf01
=NN110ff0
==0A0010a
