10000nnn0
10BB1nAn1
1111FFeG1
v010F0eGG
1XX0F1eG1
10X110e11
y1X11m0bb
yy00mm000
y0VVmm001
