1000wQQQ0
1111wQWW0
1001wQW0v
11NNNVTT1
0aN0NV1TT
0Mkkkk1T0
MMk111r11
MM1101rr0
0jjjjj1rr
