0Qhh110F1
0Qhh1FFF1
0QQQa111A
111qKKKK1
V10qK0111
V01qqq0u1
0+0011uuu
+++001vu0
0+1www001
