0DW0www01
DDWWS00X1
1vSSSXXXp
11S1u0ppp
1A0uuu01p
K1g1u0k11
Kggg11k00
K00100k10
KK0010kk1
