L1MMMWW11
LL1MMW1v0
1LwwwU11x
1L11UUU1x
I0nn0U11x
IIn1ccc1x
0Inn011bb
010001d10
11110dd00
