ZZZZZ01WW
0KKKKVV1W
1K0YYPPP0
0ddYY0P01
0d0lllP00
10s00llHH
00sss01HH
1f10s0D10
0fff0DD01
