1101VV1XX
1ccc11v0X
0010dW10X
000ddWW10
0tt11MMM1
tt100MM0G
0t1rr01GG
01rrCCC1G
00r1110A0
