111w1MM1E
011w0MM0E
0ddw0M10E
0d0iWWI0E
011iiWII0
0110i1vI1
eeee0b0VQ
11000b1VQ
011000QQQ
