0v0000010
00YY10P01
10YYPPP10
0GGGz1P10
11Guzz1X1
1Auuuz1X0
B00u0aXX1
B010b0ggg
1011b01g1
