1011ZZZZZ
1yyy00E00
10y0zzEc0
170zz0Ec1
170P00EcI
777PPPtII
1s0PtttI0
0sss1tDhh
110s1DDhh
