0y1EEEE00
0yy1wwwL0
0yIv01LL1
10IIV1L11
q11IV1L01
q110SS10i
qqq01S0ii
101ddSSi1
000d0bb01
