0100IIvA1
1D0IIxC00
1DD11xC01
01qqqxCe1
1001qx1e1
11o1q1>e0
01oo>>>e1
01o0n>nWW
11o0nnn0W
