GGG1DD1e0
0G00D0we1
A10Pg1we0
1PPPggwe*
001Pg0o**
01100oo*0
10mmm1o*1
00mm10o1v
000ZZZZZ1
