01EEEE000
DDzz11I00
1D0zz1II1
M1d11v0I<
MMdd01<<<
MM10bb<10
01pwwwll1
00p0lll01
0ppp11011
