X0V101110
X1V0xxxx1
XXav1ll11
0u0lll11P
uuuII0PPP
1u1kII01P
100k01TT0
001kBB0TT
100kk10T1
