1<01====1
0<<<010=1
v00<1111g
11z0tt1gg
1zzq0tt1g
1z0q1t100
Aqqq10llB
0DD1lll1B
0D0JJJJJ1
