0110A11v1
10011BB1Z
1qqq110DZ
a00q00DDZ
1m0qNN00Z
1mm0N011Z
0mm0NNVV1
100jjjjjW
0100011WW
