XXX0000bb
00X011m10
991wwwmm1
1991g0mm1
v090ggII1
NN10gII11
N1CCCccc0
NN001B100
11100B001
