01w100111
V0wC1qqq0
V1wCl11q0
1v0Cl01q0
4SS0ll11a
44S00l0d1
44SS11dd0
HH11II111
HH010II00
