010001a0d
00111VVdd
066660oDD
w1161oo1D
w11100oF0
wJJJJJoF1
MXX11uFF0
MMX1uuu01
MMX11u011
