100Z111DD
160Zr11D0
160Zrr10B
660Z0rr0B
060Zl01F0
11vllFFF1
0y1lA010p
yyyl00ppp
0011bb00p
