01KKKK0F1
0A111K0F0
fffBB1FF1
00f111011
ll00a1110
1lllv1055
0wwwuVV15
000uuu055
0011u0011
