0001f7770
1110f0700
NNN1ff7rr
N1N0DVrr0
0E1DDVr0g
0E1111vgg
0Exxxx11g
0E000mmm1
11BB0mm11
