DD001EEEE
D1G1Appp1
44GG00p00
44GYY1p01
140YYb101
v0w11b110
00w0u0ccc
10wuuu011
1110u1011
