10f10O10B
WWfOOOO0B
0Wff101A1
V1v0lll1K
Vmmm10llK
e6mm1101K
e660000KK
e60101011
e61111010
