0101111X1
0PPPVddX1
00P0VdXX1
10Pbbvl0x
1G1MMll0x
GG1MMl00x
0G00Ml00x
11HH00a11
01HH10101
