00DD1kWW0
MM0D1kW11
MMM00k0VV
100Akkv01
110aBB040
1110t0441
10ttt1440
110t11111
ccc000110
