eeee00a11
1100bb110
00hh01001
01hh00S01
OOOO01SSS
vO>1BB11S
0>>>00A10
0>110WW01
10www1W00
