00YY01111
v0YYC0G00
1w11C0GG0
1w11C0G10
1w101A1Bq
xjjjjj1Bq
x11001qqq
x0oooo111
x110o1a11
