1XX0xxxx1
1X0vp0b0V
0Xppp0b0V
dd10p01ll
0dA01lll0
011KKKK0G
111K100GG
0100MMM0G
00001MM00
