011XXX1YY
4440oX1YY
44l1o0v01
1ll0oo0MM
0l11o11MM
0l0d0iiM1
00dd1DiiF
11100DD0F
10CCC00FF
