1010qqq00
1001q0011
E0A0q1001
E01I1bb10
E1IIYY0g1
E1I1YYggg
1C1vffX11
1CW1f0XXX
0CWWf1011
