00FFF010P
0000F0PPP
01e00A01P
11e155BB1
00e151>>0
11e0551>>
010ccc1>0
0ll011V0v
a1lll0V01
