11VVaXXX0
011uv1tX1
01uuu1tty
0p1u0ttyy
1p001QQQy
ppp1R01Q0
110RR00Q0
00RR11O0A
1011OOOO0
