=eeeewww0
=1NN+bb0d
=0N+++0dd
==NN+1g10
FFYYJggg1
F1YYJ1000
F111J1100
1D01J0010
DD10J1001
