00qqq1ggg
0p11q10g0
1pv0q0o10
ppp55oooo
0VV050010
MMM55G0A0
MMwF0GG01
01wF1G110
11wFF0010
