wP001W010
wPPPWW101
wP0vI1110
BVVII1u11
B10I1uuu1
0MM110u1g
MMM0110gg
1001mmm1g
1001mm0a1
