ff0010101
f0nnn0r11
f0n0n1rr1
1WW11a0rr
GW0xxxx10
GGvLLL0U1
GXLL01UUU
0XXXBB0U1
100101110
