bb0ii0W10
10ii10WW1
rr101NNNw
1rr00N1Nw
g0rFF1v0w
gg1F00141
g11F01144
1110MMM44
0CCC0MM00
