001A0BB01
0II1Dqqq0
II0DDq000
710zzq111
7770zzu01
700V1uuu0
011V01u11
1YY0010dd
1YY00bb0d
