0EEEE0BBx
KkkkkA11x
K110k1d0x
Kccc1dd1x
KK11qXXX1
0001q00X0
1010qqq0v
00100www1
111001110
