1110mmm11
4401mm1dd
440p101d1
041p0GGGj
v0ppp0G0j
171WWC0Bj
070W1C1Bj
77700C00j
JJJJJ0001
