010sYY1f1
0sssYY0f1
1sVVa0ff0
zz11vl011
1zz00l100
1FFFll001
B01Fl0000
B0D0KKKK1
0DD1010K0
