0w11A11HH
0w0K110HH
1w1KKKK01
v1xxxx0E0
000001XE0
g0a0XXXE0
gg1u000E0
g0uuu1011
001u1eeee
