10VV0E0c0
0*1ffE0c0
**11fE1c1
*mm1fE11k
*mmmBkkkk
1901B1111
19910U0A0
0199UUU11
0v010U010
