0DD1ppp10
11Dl0p010
0J1l1p00a
1JVll0hh0
0JV1lvhh0
0J1YYQwww
1J1YYQ100
10II1QQQ1
101II0011
