0dd000011
1d0ccc11w
k01101g1w
k0001gggw
k01010550
kkA0MM150
II0MMM551
1II10vHH0
101VV1HH0
