BB1RR0110
01RR1T00A
11R0uTTT1
p11uuuT01
ppp1u1ggg
p11k110g0
0WWkkkk01
1W101xxxx
v0www1111
