111110s11
1111t1sss
MM0tttV1s
MMd01tV01
Mdd1j01WW
0BB0j110W
001Aj1990
CCC0jv199
0101j1019
