0LL00EEEE
1vLLL1101
1M*10tt10
MM*0tt1nn
MM**0t11n
1zP*u00nn
zzPuuu110
zPPPu1b11
1www10b01
