11CCC10v0
1J0>01+11
1J>>1+++1
1J0>>1+1V
0J101a00V
0Jlll1mmm
All00u1mm
1B11uuu11
1B100u010
