BB0MMM111
10D0MMt10
1gDD0ttt0
1gg1At010
zg1rr1100
zzrr01101
0zr0jjjjj
01**11v1W
111***0WW
