10BB1L000
0000LL000
mmm1L0CCC
1mm1L0010
0VVa0A000
v0cxn1n11
1wcxnnn11
0wcx10010
1w1x10010
