1E001v0WW
0E111061W
0E0u66660
0Euuu111V
A00u1fffV
1HH11f01c
1HH1s101c
D1sss001c
DDs000001
