KKKK1111p
K0x0BBppp
1CxmmmTTp
0Cxmm0bTT
1Cx0zzbT7
1>1zzd777
>>>11dd07
00>000010
111010010
