111010w11
110011w1V
0aOOOOw0V
10i0OvCz1
10ii10Czz
p01i01C0z
ppp0DD1TT
p00gD0TT1
10ggg11T1
