1c0101010
0c1000kDD
1c1kkkkD1
n1n0G1A00
nnn1GG010
WW1aG100K
1W111KKKK
v1100www0
1xxxx0100
