DD0010K0f
D10KKKK1f
0II0000ff
II00Pmm10
0+PPPmm01
+++1Pm0d1
1+0000dd0
10v011=1a
VV0====01
