100kkkk10
101k888dd
10O0BB80d
OOOOv08e1
1111A61e1
100M166e1
11MM161e0
01MM16g10
1xxxxggg0
