01CCC01FF
1Q01qDD1F
1Q11q0D0F
1QQQqqq11
W11k001bb
WW1kkkk11
11v1901hh
1109906hh
009916666
