10000II01
11r1IIbB0
1rrAu1bB1
rr1uuuD11
0000u0DD0
0+ss11011
+++s66661
1+1ss601v
01www1000
