0110100ff
a1ii00p0f
0ii0ppp1f
110YY0p10
111YY0v00
1OOOOVQQQ
G0O11VQ01
GGwww0Q01
G0EEEE011
