1jjjjjyyy
a0xxxxcy1
1z0010c0V
0zzrr1c0V
11z1rr000
0EEEErNN1
10110A0N0
100100NN0
0JJJJJ010
