88810VVb1
8MMWW11b1
8MMW0kk01
1yM10k001
yyyDDk111
01r0Dk0NN
1rr1gBB1N
rr0ggg1NN
010100001
