010111d09
0U0A0dd99
UUU1c1991
0U0LcX11v
M01LcXXX0
MM1LLqqq6
MM10Lq066
11011q106
100101a16
