11QQQ0l10
1dd0Q1ll1
55d0Q10l0
50vk0BBl1
550kkkkAo
10=110D0o
V1=00DDoo
V0=01011o
0==110010
