1vJJJJJ01
X00VV10B1
XXX0RR1B0
0ssW1RR0E
1sWW01R1E
ss11ccc0E
00hh100mE
10hh11mm1
100010mm0
