1www11>>1
10HHWW0>>
01HH0W1>1
1010QQQ04
0bbI00Q44
g11II0Q44
gg00I11P0
g1cccPPP1
1a10000P0
