1u00111k0
uuu0kkkk0
1u0o00v11
00ooXXDD1
bb1oXB>D0
100oXB>>>
001FF0C>1
001F00C0W
001F10CWW
