1144c710f
0U44c777f
UUU4c71ff
1U11vhh10
00Aw0hh00
0D1wq1000
DD0wq0011
10BBqqq11
110010110
