FFF11A100
11F101LL1
1O0vLLL00
OOOOV0110
1001V1bb0
101*1u011
1>0*uuu1g
>>1**u1gg
1>>1*1a0g
