011111QQQ
11110VQ44
JJJJJVQ44
16666DxK4
1ff6DDxK0
1f0ss0xK0
0f00s0xKK
00d0ss1mm
10dd10mmm
