F0NNN1000
F1N1N0RR1
FF1o0RR10
0ooooR1P1
88810a0P0
81mmm1PPP
80mm0ccc1
1y1ZZZZZ1
yyy00110v
