p11oooo00
ppp0oYY01
p01a1YYMM
0ii1611MM
ii166661M
4440101F0
44OOOO1F0
0DVVO0FF1
DD1011001
