111a10010
0hh0eeee1
1hh111WW1
C01ss1W1w
C00sVV00w
C1ssQQQ0w
0DD0Q10y1
11D0Q11yy
010A011y1
