001066660
1100nn60V
11bb0n10V
1a10nn<<1
01hh01<00
A1hhU<<0y
1G0UUU1yy
1GG0U0DDy
0G01010D1
