001VV0101
E1+1ppp10
E+++1p100
E0+10p110
Ev01BBb00
xN0N01b10
xNNN1aPc0
x111PPPc0
x01100Pc1
