XX1EEEE11
0X1ggg0M1
1X01g1MM0
00wwwuMM1
<<01uuu0A
0<0VVu1D1
1<<tt01DD
00tt1fff0
111t010f1
