000xo010p
000xo0ppp
fffxoo00p
f00xo0710
1ccc77710
P11V11710
PPPVU1TT1
P1vUUU0TT
1BB1U00T1
