101BBs100
1DD11sss0
1D1nn10s1
00A0n0100
HH1nn0mm0
HHf10mmm0
fff1100VV
1161v1W10
66660WW01
