001ZZZZZ1
0BB0000AW
001EEEEWW
1hh000wC0
1hh001wC0
100b11wC1
101bVV0k0
1011kkkk1
1ccc11001
