NN1000II0
N1001II1w
NN0DD000w
10A1D990w
qqq0o1990
q00oooo90
q00011zpV
1mmm1zzpV
10mm1zppp
