07770A011
117qqqFFF
y0701q00F
yysVVqII1
y0sss11II
0v01s0M10
0lll1MM10
ll01fMM10
10fff0101
