1HH111100
0HH0MM440
K1kMMM441
K0kkkk40v
K1Awwwff1
KK00hh8f0
00u1hh8f1
0uuu88811
00u100110
