010C11T00
100C0TTT1
011C0T101
MMM1F111q
MM1uFFF1q
01uuuvqqq
441u0bXXX
44411bXd0
011wwwdd1
