1A01HHWW0
01U0HHW0y
0UUUr10yy
D1Urr0x1y
DDrr0gx11
1000ggx01
11hh0gx11
11hh01dv1
100101dd1
