110100l01
00001ll0b
01111l01b
0FFF1l0i1
001Fj0iiz
GGG1jwizz
0G11jw1z0
A0MMjw10v
1MMMj1VV1
