1110p1100
10ppp1011
1001p1ii1
011**iiv0
1A01***lw
Gjjjjj0lw
GG10FFllw
G1DD1FlV1
11D10F1V0
