WW00v144F
1W1DD444F
005D5G1FF
10555GG01
jjjjjG110
00CCCll10
0u1lll0m0
uuu0110mm
0u01000mm
