10=10011P
0A====PPP
10OOOOWWP
NNmmO0W10
N0mm0V011
NNm11Vdd1
001qqqwd0
nnn01qw10
n0n10qw10
