1000001WW
101fffv0W
011fVV0w1
qqqEEEEw1
qHH01iiw1
qHH1ii110
Bppp00110
B0p111011
1Ap111100
