10PPP0111
0ddP1SS01
01dP0S1A0
CCCfSSlll
110f0ll11
11vff01a8
041777108
440170888
440171000
