xxxx18881
0000vdd80
MMVV01d80
MMoooo1rr
0M11o0rr0
00B001r10
00B0TT0t1
II1TTttt1
0II1T0t01
