1V0001FFF
1VEEEE10F
01Wnn0II0
0WW0nII1A
w10nn0111
w0q10fff0
w1q11f111
0vqqq100k
11001kkkk
