fffKKKK00
01fKzz1E1
1t1zz0wE0
ttt111wE1
00t001wE9
nn010DD99
n1pppD990
nn1pN1N1v
101pNNN10
