11b00VV01
00b1v1kYY
rr1kkkkYY
1rr00AWq0
10rHHWWq1
RR1HHqqq1
0RR00LLL0
00R0111LL
101110110
