0v00www00
y1VVI11DD
yyssII1D0
y0s11I10P
1ss011PPP
011r1A11P
000rr0nn0
fff1rr1n1
f10001nn0
