0000111+1
0====1+++
0=1q0v0+0
010q0hh04
0qqq1hh44
QQQ0d0044
Q00Add00p
Q1G0DDppp
0GGG1D11p
