00111100E
1001b000E
1Cg0b011E
0Cgg0111E
1CgJJJJJ0
hhAff0010
hhv1f1011
1V1Xf0www
0V0XXX001
