0101010+1
00www0+++
00ff1v0+1
mm1f00I0=
mm1f00II=
0m01BB0I=
00ccc0P==
dd01PPP10
dCCC10P10
