111www1VV
8881ssv01
8B10s0mmm
8B0ss10mm
01T11dd11
1TTT0d0b0
010T1O0b0
N0N0OOOO1
NNN100010
