A11101010
0JJJJJ010
BXXXg0ss0
BX11gg0s1
VNvNg01ss
VNNN00k11
181110k10
180bb0k01
18881kk11
