1ZZZZZ000
1IImmm555
IIbKmm515
10bKKKKv0
0k0c1XXFF
0k1c0XE0F
0k1c1XE1F
kk0001E00
111110E11
