1WW10t000
xpW0tt111
xppp1ttL1
xp00o0LL1
x110ooL01
CXXXo0L11
C00Xo10II
Ccccv1II1
0JJJJJ101
