W1v101YY0
WW0000YY1
106666P10
00B611PPP
11B101P00
0hhCCC0A1
0hh1rr001
a10rr0101
110r0ccc0
