1ZZZZZ011
V11100701
V1a177711
hh0f1070y
hh1fff1yy
00cMMM01y
01c0MM101
IIcA11CCC
1II110011
