1011010hh
0jjjjj1hh
BB1II0e10
01JVIIe11
00JV11e00
00J1>>e44
01J>>f444
00J1>fff0
000A0v010
