00ss10XXX
11s00fffX
1ss01fVV0
101bbvddw
01110R1dw
01100RR0w
01II00RR0
1II1HH11B
0001HH10B
