1101HH<01
1lllHH<<<
llIIjxM0<
0II0jxMM0
1t11jxMM0
ttt0jx01B
00t0j1W1B
101f0WW00
100fff0VV
