0V0101II0
0V1c0G0II
505cGG101
555c1G1RR
1ttWW0RR1
tt1oW0R00
0t1oov1FF
011o1a01F
000o0110F
