001www1v1
01nnn1Wkk
g1n0nWWk1
ggTVVt1k0
gTT1tt0k1
01TT1tt10
1S01JJJJJ
0SSS01000
A01S00110
