100EEEE10
00c0011B1
00c00A1B0
11c1o0T10
1p0oo1TTT
1p11ov1T1
ppp0o0515
VV1a11555
11xxxx001
