10111www0
1>11+0fff
>>1+++11f
0>>1+0Wo1
10BB0WWoo
g110LL1o1
ggLLL11o0
gAjjjjj01
10EEEE010
