01D1II000
00DD1II01
100ii11BB
fff1iiG10
11f11GGG0
rr1kkkk10
yrr010k01
yyr0v0011
y1VV1xxxx
