1ZZZZZ001
C0QQQ1vhh
C0Q01x0hh
C1Q1Dxb11
0U1DDxb01
UUU00x0q0
1U1YY00q0
101YYqqq1
jjjjj1110
