10JJJJJ01
RR0cv1z1b
1RRc1zz0b
01Rc1zff0
1U01mm8f1
UUU0mm8f0
1U01m1888
00BBWW111
0001W1110
