101111111
001iiDD10
1hhViiDg1
1hhVNNgg1
b0v1N10g0
b01+NN1I1
01+++0II1
000+11I00
www1BB001
