jjjjj0100
00VV1hh00
WW1uvhh1g
WOuuuX0gg
0O1u1XXXg
1OO10DD01
0O1100D10
00EEEE1G1
010001GGG
