1xxxx0ymm
W0hh1yymm
WWhh01ym1
00A0ccc55
DDdd10115
1DdRR1155
11RR0BB01
00R010001
101001001
