0OOOO01NN
g00O0BB1N
gg11A11NN
g0u0jjjjj
1uuu11001
11u01X0WW
000f1X1W1
1fff0XX10
0111v01VV
