gggA0T111
1gvjTT111
cw0j1TT00
cw1jB00DD
cw0jB10D1
V0xj01p00
V0x1ppp11
10x100p00
01x001111
