EEEE0qqq0
0011DD0q1
100A1D0q0
1BB0mmm00
0ggg0mmV0
99gyyy1V0
199cy1W10
019c1WW11
110c00010
