101011DD0
1u100q0D0
uuu10qA10
0u1qqq1KK
V0yyy1nnK
V10ytt1nK
155tt0nnK
151vt10B1
1550110B0
