00001o010
0VVoooo00
01qv0>1e0
00q1>>1e0
MMqqq>>e1
MMwww00e0
0Mjjjjj10
11D1BB0II
01DD00II1
