110u0D011
00uuuDD1A
001u1e1I0
00a11e0II
hh1v0eJ0I
hh<01eJ10
<<<0W1J10
<11WW0J00
1VV111J10
