1y1WW1011
Fyy0W1www
FyGGGv1t0
FF0G10tt1
11Sf1b0tt
SSSf0b110
S00ff1qqq
0B100100q
1B111100q
