cMM00000y
cMMM0A0yy
c0l0EYY0y
0ll0EYY01
1l0jE01v1
1l0jE00S*
i00j1SSS*
ii0j0S1**
0i1j000*0
