1111BB0A0
1QQQ1eK01
1Q011eK10
0Q010eK01
11011eKK1
jjjjj0111
0W1VVlll0
0WW1a10ll
v01xxxx01
