JJJJJ0111
11YY0CCC1
11YYmm00D
1*10mm0DD
1**00mA10
01*0g1qqq
11*ggg01q
100v0001q
www101bb1
