0111GGG11
1II11G000
II0MMff01
00MMMf0e1
0O11vf0e1
OO1mmYYe0
1OmmmYYey
1O0=0bbyy
000====1y
