V101t0101
V0vttt1O0
16111t1O0
6611p1aOO
0601pA1O0
161pppL1C
z1f01LL1C
zzfffL01C
0z100L011
