1====0000
1=0106666
011t<006E
10tt<<<0E
101tt1<0E
00111p1vE
dd0pppDD1
d1g01pD0B
0ggg1A01B
