01CCC001B
W1**1RR1B
WW0***RR0
01mmm0vR0
ii1mmz01A
1ii1zz0p0
010uzppp0
01uuu00p1
000u01000
