1I0010V11
II0ss0V0y
I1BBs11yy
1E00ssv0y
0E0eXXn1n
1E0eX1nnn
1E0eXp000
11Ge1p001
1GGGppp00
