100CCC10
MMM00111
MM0JJJJJ
ggg0W110
0g11WW11
10i0ttv1
00ii0ttV
001i1t1V
