00qqqHH1
1101qHH1
0s01q10C
0sssR11C
c0vsRR1C
c0199RR1
c0V09910
00V11900
