***10010
00**1111
YY0080T1
YY118TTT
00888T01
1a1ii0I0
b1iiD0II
b000DD0I
