11Je0100
10Je1001
01Je1101
01Je1001
11J0nnn1
110An1nv
0BB1wwwf
01VV0fff
