10NNj110
Z11Nj111
Z1NNj001
ZC00j110
ZCV1j111
ZCVD0rr1
0WDDrr0d
WW11r1dd
