0101F010
1000F100
01i1FF11
00ii00BB
100i1A11
qqq1ccc8
qzz0v118
q0zz0888
