100111l0
ppp10ll1
0p101l11
0p0uvlA0
01uuuz1G
101uzzGG
1100zB0G
0www0B00
