11000010
1JJJJJf0
Es10fff0
Esss1221
E11s120V
E101i20V
1HHii200
1HHi10v1
