01mm0010
00mmm001
0xxxxhhC
w1ii0hhC
w00iiG1C
w0001GG1
04441G01
144111BB
