0J1110y1
1Jg0a1yy
1Jgg0ky1
1Jg01k0v
1J011k*0
11DDkk*1
HH1D1**1
HH001*00
