11110101
0010010C
ccc0a10C
1VVj011C
v00j0DD1
044j10D1
144j1N1N
140j0NNN
