100RR0A1
0FFiRR01
1F0iiR00
1F01i100
eeee1mm0
10>>mmm1
1>>0v101
11>11VV0
