00s001VV
sss01+01
s10k+++B
0b0k0+0B
0b0kvRR1
100kk1RR
0JJJJJ0R
11100010
