01101111
010C0101
110C11x0
cccCbbx1
10Ae00x0
0U0e01x0
UUUe1v01
1U0e00VV
