110*0111
11a**111
1fv1*101
0fff*010
A100ewww
1FFFe001
0F10e000
11BBe100
