11www000
1v01o101
>0oooo10
>>>1B1a1
0>00Bl10
OOOO1l00
00O0Gll0
100GGGl1
