0fffGGG1
01+fvGa0
0+++bbC1
11+001C1
101==0C1
101=1B00
100=0B10
011=1101
