1000zz0F
66660zzF
0061W0FF
dd0WWK11
1dKKKK01
SSnnn101
1Sn0n110
0SSa1100
