0qqq1v01
C11q0dXX
C10q0ddX
C001e01X
1G01e1z1
GGG0ezz1
110Dez10
10DD0010
