00V1p011
y1V0ppp1
yy0vp010
ymmm0u01
0mm0uuu1
11A00u01
0B1HH010
0B1HH011
