11C00111
01C10011
00C0XXX1
1B11X00w
1B1vpppw
10HH0p0w
10HH0p11
0010a0bb
