11001011
101p1011
110ppp10
100p11c1
1IIv01c0
II0RVVc1
001RRaWW
11A0RR1W
