WW00MMM1
1W11MM1A
118881U1
0V1b8UUU
1V0b80U1
ggg0o101
0g1oooo1
11111111
