w10VVg01
w1>0gg00
w1>>1g00
A>>0a1nn
1QQQ010n
110Q00nn
MM1Q0111
MMM11010
