11100101
01ccc11b
01GGGi0b
II1G0ii0
0II0D1i1
010DD11W
010zz1WW
11zz0v01
