01011y01
KKKKyy10
KXXXLy10
gggXL161
0g1LL066
00iL0M60
0ii0MM60
1i0aMM00
