0mmm1FFF
11mm111F
q001u1A0
q01uuu1D
qqq0u0DD
WW01=011
W100====
0www0011
