010E1777
NN1Eg171
0N0Egg70
NN0Eg0a6
01L01i66
01L01ii6
10LL00i6
010L11v0
