v1WWi100
0y0Wii11
yyy00i10
C00010bb
C1eeee01
C001EEEE
0FFF1101
0F010111
