00vE00a1
1w1Edd10
0w1Ed01s
1w1E0sss
01VVUs11
0M0UUU10
0MM0U011
0MM10101
