0mm0VV01
1mmm10w0
1000f1w0
OOOOf1w1
10O0ff0v
SS1B11b0
0S1B01b0
0SS11100
