11001101
011CCC11
01B100I1
00B1mmII
nny0mm0I
n0yym010
nnydv000
11dd0VV1
