10055010
www15111
01055dd0
1001exd0
DD00ex0i
D011exii
1MMMexi1
1MM1A101
