01A11111
1C10nn00
0C011n00
1C01nn01
E0dd1001
EWWd1ii0
E1W1ii01
Ev1ZZZZZ
