dd01VV11
dyyy1mm0
1ky0vmm0
0kkkk1m0
1T0A00P1
TTT1PPP0
11T110P0
01000101
