0ZZZZZ00
ggg01cz0
1g111czz
10ii1c0z
100iiVV1
100DD1NN
111D0A1N
100100NN
