11110110
0000lll1
00hh01ll
00hh10A1
0i011T0E
ii1TTT1E
iv01TWWE
00www0WE
