VV0zz001
01zzfff1
0v00f00d
000k10dd
kkkk0GGG
1011Q1G0
1111Q11A
01QQQ111
