BB11P1l1
00PPPll0
DD00Pl11
vD010l10
1YY170dd
1YY071d0
0017771a
01001000
