011jjjjj
1nnA0000
10n1DD01
0nn0D0I0
v01hhII1
1V1hhI00
0V1W0110
00WW1111
