11JJJJJ0
HH111u00
HH11uuu1
10Ag1u1q
00ggg01q
10111qqq
1www1000
v111xxxx
