111101b1
001011b0
100ll01a
C1YYlll0
C1YY0zz1
C11Aw1zz
1DD0w100
0D11w000
