10001mmm
1010k1mm
0kkkk000
111<<aI1
0FFF<1II
811F<<0I
810vN1N1
8880NNN1
