10110101
11U**101
1UUU***1
A0Ufff0v
0L1fwww1
1L00qqq1
1LL1q10a
10L1q011
