011t11V0
1KKtttV1
0K10t11>
0K0f0>>>
0K1fff>1
A1DDzzrr
01Dzzrr1
01000r11
