0GGG1190
01G01991
KK11991v
K01100y1
K10iiyyy
K1ii1fff
1DD11f10
00D001a0
