11001ggg
EEEE10g0
5550Aa10
5151bSS0
0x0wbS10
1x1wSS11
0x1w1010
0x101001
