kk110BB1
k1CCC0==
k0001HH=
k1101HH=
0t00101=
0ttt10W0
d1t10WW1
dd10100v
