10110NN0
001j10N0
011j1NN1
111jCw1I
111jCwII
mm1jCwIv
mmm0g0W0
011gggWW
