991yyy00
0991yu10
xf90uuu1
xfff1u00
x10DD1bb
x01D1111
10A11111
101JJJJJ
