11A001U1
101O1UUU
1OOOOgU0
77701gg1
f7001g00
f7ccc101
ffv11100
011ZZZZZ
