P0010i10
PPP11ii0
P10QQQi1
110Q0gBB
111QggYY
0ppp1gYY
11pwww11
00p000VV
