11Jxxxx1
10J0111V
11J1010V
00J001v0
A0Jff1tt
0P1f1tt1
0P1f00t0
PPP00a10
