110A0D11
FFF0DD00
F11lll01
fff01ll0
00f01101
101eeee7
xxxx1777
1011v017
