10000mm1
0HH10mm1
1HH00m0a
110D01e1
10DD01e1
0B0X11e1
1B0X1ve1
101XX0VV
