101a0110
01g0eeee
1ggg0110
00***MMM
0**1FvMM
0010F0+1
000FF+++
1BB000+0
