110o010B
11oooo0B
mm1001A0
mmEEEE01
0m000w00
10nnnw11
00n0nw1W
1000v1WW
