0101a100
VV0WWi00
11w0Wii1
11w1u1i1
00wuuu0F
KKKKu10F
K011G1FF
000GGG11
