001o1100
0oooo11C
0v044kkC
81444k1C
80000kB1
88810kB0
111MMMhh
110MM1hh
