11v00100
000ZZZZZ
55501o10
5051Go11
DD1GGoo1
D1A1Go10
1eeee0b1
000111b1
