00010000
V1b14411
V1b44400
0YYmmm01
BYYmm100
B1000n1n
0DD01nnn
A1D01110
