000011A1
110oyyyE
0ooooy1E
0000vhhE
0www1hhE
001tt1P1
00ttPPP1
111t10P1
