10101U1c
0110UUUc
101L0U1c
101Lvbb0
01LL0XXa
11L1IIX0
110II0X1
110www11
