0yyy0001
00y10QQQ
0v0eeeeQ
Vll0101Q
V1lll0O1
hh100OO0
hh0HH1O0
010HH0O1
