0mm01BB1
mmm0100A
101iLLL0
00ii00LL
1+i1dd0V
+++10d1V
1+1xxxx0
00100010
