01DD01YY
SS0D10YY
0S101v11
1SS1>010
A011>>>1
11t11>00
ttt0eeee
1t1a0000
