0T0NNN01
TT0N1N11
1TT1A100
ccc00110
777jjjjj
17a01V11
17101V01
01www000
