0100sW0v
01sssWW0
01s1100V
1d0ooooV
1dd1o110
NN010DD0
N1FFF1D1
NN00F101
