11e11000
10e01777
11eYY170
00eYY171
444dd010
440d0DD0
01A1a0D1
010CCC00
