0011GGG0
00c10G10
11c0BqO0
11c0BqOO
hh0qqqO1
hh1000O1
1ZZZZZ11
v01011VV
