VV101dd1
11990d11
099ttCCC
09ttF101
wo1tF001
woo0FF0I
wo1101II
0o0100I0
