110qqq01
01z11qDD
1zz11qD1
1zOOOOhh
SS>0Ovhh
0S>>>a00
0SS>1011
11100000
