0V001001
0VEEEE01
v10701A1
1777110C
0007110C
1bb01t0C
111a1tt0
0010tt01
