10yyyr01
000y0rr1
0VVdd0rr
W0b1d101
WWb1LLL0
0QQQ01LL
0Q10II00
0Q1II001
