11100U11
11o0UUU1
00o01U1w
1oo1A01w
01o01E0w
dd1nnEv0
0d01nE1W
001nnEWW
