101t0110
11tt1dd0
MM1tt1d0
MMM00q00
101DDq11
00V0Dqqq
W1V01BB1
WW0www10
