11444110
1x144A0D
1xqqq0DD
0xqGGG11
0xq0G001
V00ggg11
V0a1g011
01110111
