111111WW
100p01W1
000ppp0v
001pwww0
01o0eeee
00ooFFF1
01o0F110
00oA1CCC
