01p11ggg
00ppp0g1
55p11001
51vjjjjj
55044400
1DD04410
0D1CCC00
001011A1
