0====000
vSS0=1+0
1S1p0+++
SS0ppp+l
11TpA0ll
1TTTf0l1
0T10f1l0
1001ff10
