jjjjj001
01011b11
HHV01b10
HHVss110
WWK1s111
W1K1ss10
0vK1A110
01KK1010
