0fff1nnn
100f1n1n
1110u010
NN0uuu00
N0A0uVV0
NN0II01v
1110IIX0
1011XXX0
