Veeee01E
V0W01m0E
1WW0mm1E
v0u1mm0E
1uuu00D0
01u1O1DD
11OOOO11
10111010
