C1f10a00
C0fff1u1
C1110uuu
0JJJJJu0
WW1>>0E0
W0v0>>E1
0001>1E0
111101E0
