11yyy001
000ykkkk
444lv0Bk
440l10B0
01llNN1G
00l1N1GG
011fNN1G
1fff0010
