ccc11011
P00b1N0N
PPPb0NNN
P0dBB1w1
10dd00w1
111101w1
000***1v
01**1111
