1f1hh110
1f1hh111
0ff01k00
HHXXXk11
HHXRRk11
0VRR0kk1
0VR0CCC0
v1011110
