01011N1N
1kkA0NNN
V0k0I001
V0kII111
1vkI0101
1aXjjjjj
00X01000
10XX0001
