10a1www1
0o11101X
oooo0v0X
0011bTXX
10BBbTT0
1001TT01
0N1N0101
1NNN0001
