010010kk
1101444k
00WW144k
1y0Wii1k
yyy11ii0
jjjjj1TT
CCC01TT1
110BB1T1
