01FFF111
10F0w0t0
1J11wttt
1J11wt1v
0J0ssVVg
1J00s0gg
0J00ss1g
00BB0011
