110P1000
0PPPnnn0
Q10Pn1nv
Q1bb0gw1
QQQ1ggw0
101D0gw1
11DDVV01
10111011
