01ff11v0
11f0ew0=
10f1ew0=
1001ew0=
10B1e1==
10B00b10
1A001b00
01JJJJJ0
