0A111000
01TT0NN0
hhVTT0N1
hhVT1NN0
0*nvn001
0*nnn111
**010g11
*111ggg0
