11B01l10
R0B00ll0
RR0A11l1
1RR001l0
0jjjjj0z
q11001zz
q1**00z1
qqq***0v
