dd1lll01
d0ll100V
0SS0p11V
0S01p0z0
SS0pppzz
00JJJJJz
0010515A
01105551
