00111101
10100q01
11z10q11
0zzqqqA1
1zu11B10
Wuuu0B10
WWu1bbD1
01v00DD1
