10000t01
0110tt00
0ll00tt1
10lll055
rrVV1150
0rr0W155
BBr1WWA1
11EEEE10
