10f11440
11f10441
1ff0L411
s00LL1>>
sssL0>>1
1UsLv1>1
UUUbKKKK
1U1b110K
