0>>1f011
>>0vf1bb
0>11ff11
xn0n001P
xnnn1PPP
x00FF00P
x10F0HH1
011F1HH1
