SS0HH000
0S0HH100
0SS01101
g11NN011
gg10N0W0
g0bNNWW1
00bYY01V
1a1YY11V
