10ppp001
0z0p1110
0zzp00a0
v0z0hh1E
0>01hh1E
0>>P010E
>>1PPP0E
111P11A0
