010000W1
00www1WW
010HHv00
110HHccc
mmm1rG10
mm1rrGG0
11rr1G0A
00110111
