110<0010
1R1<<<i0
0RR00<ii
00RR11vi
1U001ddV
UUU10d1V
1U0HH0hh
100HH0hh
