I1011DD1
II111D10
1I11P001
00PPP11*
111sP10*
010sss**
ccc11s*0
000aVV0v
