1XX10777
1X0VVT71
SX0TTT70
SSS0T1E0
00SgggE0
1ii0g0E0
11ii11E1
0010a001
