1i01101B
1iiLLL0B
11i10LL0
010eE11w
100eEV1w
011eEV1w
010eE1v1
0011bb11
