010=001v
ppp====0
0pVhhA00
0pVhh1DD
10e1001D
10e01HH1
10e01HH0
01e11101
