01101NN1
010u0N0A
10uuuNN1
001u1g0C
1dd1gggC
55d0000C
51xxxx0W
550001WW
