1yyy110E
v0y1z00E
1u0zz00E
uuuzcccE
0u0e0KK0
010eC0K0
001eC1K0
011eC1K1
