444hh101
044hh01p
xDD11ppp
xD00f10p
x0NNf011
x00Nff01
0yNN01LL
yyy1LLL0
