1001C100
010tC1mm
11ttCmmm
WW0ttDD0
0WLLLuD1
vLL0uuu1
0=011u11
0====110
