ZZZZZ0y0
0k011yy1
1kkkk1y0
D0110c0W
DD11PcWW
01PPPc11
1B00P1hh
1B0001hh
