1CCC1RR1
0==1RR10
1=nnR01S
1=n11SSS
0=nn1S10
v010ccc1
1Vdd1111
1Vd00001
