VV000t11
11v1ttt1
0W00t01A
1WWg10C0
01ggg0C1
nn1011C1
n01NNN01
nn0N1N01
