www1W101
111WW1a1
1Jv11o11
1J101o10
0J11oo10
1Jhh1o11
1JhhLL01
01LLL1A0
