0r01b011
1rr0b100
d0rr1100
ddXXX0T1
0101XTTT
010NNv0T
100N1AW0
011NN1WW
