011YY01v
100YY1y0
0qqq1yy1
1DDq11y1
1gDqEEEE
1ggCnn01
0g0Cn011
110Cnn11
