0000FFF0
1BB1F1v1
100Afffx
0000f10x
kkkk000x
101k0iix
1011iiV1
110000V1
