KKKK0001
000K0010
QQQaEEEE
Q011uv01
Q10uuu55
0011u050
0n0nW055
0nnnWW00
