11w00000
10wDD100
10wD1G10
YYAvGGG1
YYff01s0
11f0sss1
11f1s010
1a101010
