1ss01000
1s100100
ss10X001
00f1X001
fffXX100
wwwaNNN0
11OvN1N1
OOOO011A
