0001>>01
1u000>>0
uuu11>11
Bu1010=1
B0hh1f=1
0Ahh1f=1
00G0ff==
0GGG1v00
