dd111011
d1rr0010
1rrFFF00
1r0F11U0
aNN10UUU
01NWW0U0
1NNW1zz1
00v1zz10
