0010o0L1
0x10o0L1
0x00ooLL
1xl0o01L
1xll10A0
01WlXF11
fWWlXFFF
fffXX100
