11011110
0EEEE011
44010LL1
441LLL1D
04ooooDD
v1VVo1p1
1ccc10p0
01101ppp
