00111100
01dd1101
01d01100
hh1jjjjj
hh011101
111CCCVV
0BB01vA1
ZZZZZ011
