0001VV0v
1ggg1071
10g1j071
1HH0j777
1HH1j001
101DjT00
11DDjTT0
0cccTT00
