110C10T0
a1gC0TTT
VggC0T11
V0g1A011
055jjjjj
10510110
15511010
110xxxx1
