11HH1NNN
01HH0N0N
1V01T0f0
0VTTT0f0
wnnT0ff1
wn0ll010
wnn1lll1
1v001110
