1101W000
0f11WW1v
1f1bb1V1
0ff0FFV1
101aF0B0
0100F0B0
1101010A
11110001
