01110111
nnn0k100
n0n1kkkk
110bDyyy
1S0bDDy1
0SSSVVBv
010S00B0
01011100
