0100010b
VB1ccc1b
VBzz11l1
CwLzzll0
CwL01l01
CwLL0l01
110L1100
01011111
