00101u00
0111uuu0
0nnn0u0A
1nvnMMM0
0xpVVMM1
1xppp11I
1xp100II
0x0011I0
