00000G0v
10U1GGw1
0UUU0Gw1
10U00tw0
DD01ttt*
Dccc00t*
1000hh**
0100hh*0
