0100<<11
00v0<0VV
101<<qqq
PPP1Gq10
1P1GGq10
1P01G1hh
10A100hh
1101bb11
