00q10zz1
00qIzz1y
qqqII1yy
QQQkI11y
Q10k1Av1
Q10k0ff1
100kk0f1
110000f0
