11011001
01u111==
0uuuCCC=
j0uAmm0=
j0Lmmm0=
j1L110v1
j0LLYY00
j10LYY01
