101KKKK1
110Kq01L
0100q10L
11qqq1LL
1a0V1kL1
001V1k1I
0110vkII
xxxxkkI0
