11ZZZZZ1
1*r1gggW
1*rr0gWW
**1rr001
*hh10A01
0hh100SS
JJJJJ0S0
11001SS1
