00CCC11c
0OWW010c
0OOW100c
1O701dd1
0O777d0a
T0710YY0
TTT01YY0
0T011110
