0p10d1V0
0p1dd1V0
pppBBk0v
1NN10kW1
1N010kWW
0NN1Ukk1
111UUU10
1000U000
