0701v0y0
1777Eyyy
07f0E110
fff0E1T1
001bE0TT
0u0b1TT1
uuu0D001
1u0DD001
