11101100
0100eeee
000l1990
001lv099
FF1llW09
F1HHlWW1
F0HH1d11
0100Add0
