GGG01000
0G001p1x
J01ppp1x
J0k00p0x
J1kWW00x
J1kW0991
Jkk19911
0A1a9110
