0111I100
Z01II011
Z11I1DD0
Z0llA1D0
Za1lll01
Z05511nn
0v05001n
015511nn
