0z001101
jzz00001
j1zoooo1
j0kvoA1I
j0k0VVII
j0k1G0I0
0kkGGG11
10001011
