0g01A001
Zgg00F00
Zg1FFF10
Z1b100I1
Z0b1o0II
Z11ooooI
1====100
v010=101
