OOOO1BB0
11O1K110
mm1WKKKK
mmmWW001
001f190v
0fff1990
0110dd99
11101d11
