10Gwww10
1GGG10V1
0l11IIV0
ll1II10X
lDDq0XXX
l1Dq11r1
0qqq0rr1
0011rr00
