101kkkk1
011kW11a
0v1WW1g1
10V10ggg
00VB1000
110B0110
DD11O011
D0OOOO00
