01001011
0111Shh0
01SSShh1
01S0<<1r
0G00<1rr
GGG<<rr1
011HHVVa
001HH10v
