M0KKKKV1
MM1j0KV1
MM1j011v
10Tj5151
TTTj5551
0T1j0111
mmm0kkkk
mm01110k
