10mmm010
0g1mm001
gggwww10
555aFFF1
505010F1
1vP0HH11
10P1HH10
1PPP1010
