1001HH10
01ssHH1A
010s10B0
100ss1Bp
0hh11ppp
1hh000Vp
000011V0
1ZZZZZ0v
