1111CCC0
001U000c
D1UUU11c
DDvU1g1c
100VVgg1
01=01g1q
11====1q
00001qqq
