1011101A
001EEEE1
QQQ0010x
Q0ggg1qx
Qc1g10qx
1c00qqqx
1c066660
www00611
