1B000110
0B000100
11CCC>10
KK1i>>>0
Ka0ii0>0
K0u1iz0V
Kuuuzz1V
01u1z100
