x1KKKK10
xC100K10
xC>0wwwa
xC>>nnn1
D>>0n0n1
DDhh1001
10hh1011
01011011
