0FFF1110
wwwF10tt
NNNv0tt0
N1N1V1t1
010KVl00
KKKK1l01
010o1ll0
1oooo1l0
