01D00100
10DD0111
0T100101
1TTT101b
11Txxxxb
10vG10gw
10GGGggw
0eeee1gw
