1011gyyy
0011ggy1
10MMgvb0
10MMw1b0
110Mwo01
FFF0woo0
F1011o11
0EEEEo01
