01TT1011
0TT0OOOO
a1T11O10
0mmmV1K0
e0mmV0K1
ewww04K0
e00044KK
e1104401
