1110EEEE
01KK1000
1X1K011a
1X1K10t0
1XXK1ttt
11Av0t10
1YY1d000
0YYdd000
