0XXXS111
1XSSS101
41S01BB0
4401D001
441DDa11
00v1g0nn
000ggg1n
110110nn
