010vmmmO
0VVj0mmO
800j00OO
801j111O
888j0HH1
111j1HH0
1101d11A
111dd111
