1O144mm10
1O144mm11
OOv140m11
1O1=hh100
C10=hh111
C11=11s00
C1==A0sss
1N1NV110s
1NNNVccc1
