R11HH1610
RR0HH6666
1RRWWFF11
B10W0wF01
Bnnn0wF11
1n1n0wb01
a000v1b10
1jjjjj011
010100100
