HH0gggO01
HH1GgOOOO
00GGGppp1
1v100Bp01
w0888Bp11
w010811dd
w000810d1
04440ii01
144010ii1
