1011100D0
0011AaDD0
jjjjjSi01
011SSSii0
011SbbVi1
0TT100V0y
TT100W0yy
1T100WW0y
0000v1111
