110111444
111101440
ii1jjjjjX
1ii000XXX
111bbvR11
ccczzRR1A
10zzRR1P0
01DD011P1
01D010PPP
