00t0a***1
0tttV00**
0zztV1100
zzrvss110
0rr0s0FFF
rr1ss100F
0CCC0QQQ0
0111D01Q1
1111DD1Q0
