10100FFFg
1v1D1F1gg
V01DD1s1g
V1A0sss11
1=0Is11hh
1=II1l0hh
1=I10l110
==000ll11
10xxxxl00
