nnnWW1v00
n0nW1yTT1
1jViyyyTT
0jVii11T1
1j01i0B11
1j0100B11
1j01pA0G1
11ppp1GGG
0000p1101
