001JJJJJ1
0100n1n0C
1001nnn1C
01tt1S10C
0tt00SSS0
V0t0mm1S0
V00mmmArr
0zz0WWrr0
zz0v1Wr00
