10FF1000
01F1u000
10Fuuu00
BBv1u001
WWAp0t01
Wppp1ttt
0YYp01t1
0YY10101
