11000101
11011001
ii11nnn1
Vii0nTn1
V00f0TTT
1WWfffT0
v1W00B1A
01100B00
