1000DD10
1101D000
0hh11GGG
1hh0m1G0
100mmAv1
ii1mm007
0ii11777
ZZZZZ017
