1WW0DD10
00W01D11
1V0pppSS
0VQ1p1S1
v1Q1pSS0
10QQQmm0
0ll00mm1
10lll1m0
