0xxxx017
we100777
we00BB17
weHH11I1
1eHHllII
01lll0qI
100111q0
1010qqq1
