0l800001
ll810VV1
l088811w
l110100w
1b11GGGw
0b0A0G1I
11mmm0II
001mm1I0
