110Sppp1
1SSS0p11
0S10Bp10
E111B0u1
E0wwwuuu
Evccc1u1
E0***011
0011**11
