1ccc0000
0011qqq0
1100q00e
0111qKKe
00100Kwe
1111VKwe
0100VKw0
10CCCvA1
