0001WW00
00nnW111
000n1yyy
11nn01y0
0a1Att0w
MMM01ttw
MM0DDt1w
0010D101
