1111hh10
ccc0hh00
0x0k110O
1x0kBB0O
1x1k11OO
0xkk1v1O
10wwwHH0
00010HH0
